北京	北京市
四子王	四子王旗
临潭	临潭县
华坪	华坪县
孝南	孝南区
丰泽	丰泽区
站前	站前区
阿鲁科尔沁	阿鲁科尔沁旗
瑞金	瑞金市
黄骅	黄骅市
苍南	苍南县
东丰	东丰县
赤壁	赤壁市
双江	双江县
惠民	惠民县
新左旗	新巴尔虎左旗
海港	海港区
德化	德化县
汉南	汉南区
五原	五原县
乌马河	乌马河区
带岭	带岭区
阜新	阜新蒙古族自治县
冠县	冠县
台儿庄	台儿庄区
桦南	桦南县
彝良	彝良县
宣州	宣州区
朝阳	朝阳区
如东	如东县
宾川	宾川县
柘荣	柘荣县
平和	平和县
五峰	五峰土家族自治县
铁岭	铁岭县
华容	华容区
汝南	汝南县
新宾	新宾满族自治县
元氏	元氏县
大渡口	大渡口区
隆昌	隆昌县
砀山	砀山县
云龙	云龙县
宁南	宁南县
夏津	夏津县
容县	容县
鸡冠	鸡冠区
长兴	长兴县
灵璧	灵璧县
富锦	富锦市
抚远	抚远县
房山	房山区
金安	金安区
山亭	山亭区
西安	西安区
源汇	源汇区
兴宁	兴宁区
淮上	淮上区
惠山	惠山区
宜丰	宜丰县
廉江	廉江市
江南	江南区
柞水	柞水县
江源	江源区
金山	金山区
张家港	张家港市
罗庄	罗庄区
莱州	莱州市
嵊泗	嵊泗县
卢氏	卢氏县
永善	永善县
密云	密云县
扶余	扶余县
林州	林州市
汝州	汝州市
金乡	金乡县
锡林浩特	锡林浩特市
朔城	朔城区
盐湖	盐湖区
兴宁	兴宁市
开江	开江县
阳信	阳信县
武平	武平县
许昌	许昌县
怀集	怀集县
禹州	禹州市
襄城	襄城县
海城	海城市
鄄城	鄄城县
延寿	延寿县
汉阳	汉阳区
双城	双城市
大田	大田县
静海	静海县
乌后旗	乌拉特后旗
镇安	镇安县
凤县	凤县
襄垣	襄垣县
绥德	绥德县
琼结	琼结县
错那	错那县
辰溪	辰溪县
宝山	宝山区
广平	广平县
恭城	恭城瑶族自治县
怀来	怀来县
冷水江	冷水江市
云溪	云溪区
岳阳	岳阳县
长武	长武县
商南	商南县
松北	松北区
浠水	浠水县
新化	新化县
涟源	涟源市
金凤	金凤区
梅河口	梅河口市
山阳	山阳区
肥乡	肥乡县
石岐	石岐区
郁南	郁南县
仁化	仁化县
嘉定	嘉定区
临澧	临澧县
溆浦	溆浦县
鼎城	鼎城区
会同	会同县
沅陵	沅陵县
蕉岭	蕉岭县
新和	新和县
印江	印江土家族苗族自治县
玉泉	玉泉区
二道江	二道江区
泸溪	泸溪县
察右中旗	察哈尔右翼中旗
崇文	崇文区
肥西	肥西县
北塔	北塔区
东乡族	东乡族自治县
广河	广河县
红古	红古区
东安	东安县
零陵	零陵区
湘乡	湘乡市
雨湖	雨湖区
太仆寺	太仆寺旗
正蓝	正蓝旗
阿合奇	阿合奇县
双柏	双柏县
新邱	新邱区
滨江	滨江区
陕县	陕县
伊春	伊春市
湾仔	湾仔区
武陟	武陟县
汉口	汉口
石首	石首市
龙山	龙山区
石棉	石棉县
龙子湖	龙子湖区
鼓楼	鼓楼区
新区	新区
大丰	大丰市
修文	修文县
延吉	延吉市
西岗	西岗区
榆树	榆树市
铁西	铁西区
西市	西市区
灯塔	灯塔市
大石桥	大石桥市
昌图	昌图县
太平	太平区
彰武	彰武县
海州	海州区
清河门	清河门区
子洲	子洲县
敦化	敦化市
孝义	孝义市
岚县	岚县
霸州	霸州市
独山子	独山子区
西乡	西乡县
镇巴	镇巴县
临渭	临渭区
新龙	新龙县
沅江	沅江市
南岳	南岳区
常宁	常宁市
珠晖	珠晖区
衡南	衡南县
元宝山	元宝山区
克什克腾	克什克腾旗
油尖旺	油尖旺区
宜秀	宜秀区
宁国	宁国市
高平	高平市
禅城	禅城区
徐汇	徐汇区
临潼	临潼区
阎良	阎良区
牟平	牟平区
芝罘	芝罘区
鹤城	鹤城区
炎陵	炎陵县
衡阳	衡阳县
环县	环县
镇原	镇原县
临泽	临泽县
山丹	山丹县
甘州	甘州区
杭后旗	杭锦后旗
达茂旗	达尔罕茂明安联合旗
尼木	尼木县
顺城	顺城区
通河	通河县
荣昌	荣昌县
闸北	闸北区
淇滨	淇滨区
虹口	虹口区
岳阳楼	岳阳楼区
尖山	尖山区
西贡	西贡区
白玉	白玉县
五台	五台县
景泰	景泰县
泰宁	泰宁县
白银	白银区
敦煌	敦煌市
金塔	金塔县
永昌	永昌县
西和	西和县
同安	同安区
周宁	周宁县
葵青	葵青区
南开	南开区
明山	明山区
鱼台	鱼台县
德格	德格县
正宁	正宁县
宁河	宁河县
津南	津南区
镶黄	镶黄旗
石鼓	石鼓区
科左后旗	科尔沁左翼后旗
威县	威县
洪雅	洪雅县
库车	库车县
平房	平房区
磐石	磐石市
孙吴	孙吴县
华阴	华阴市
明光	明光市
临邑	临邑县
阿尔山市	阿尔山市
大竹	大竹县
瑶海	瑶海区
宁津	宁津县
明溪	明溪县
南溪	南溪县
宣汉	宣汉县
五莲	五莲县
临淄	临淄区
玉环	玉环县
饶平	饶平县
繁昌	繁昌县
怀宁	怀宁县
金城江	金城江区
穆棱	穆棱市
鹤山	鹤山区
灵武	灵武市
城东	城东区
茶陵	茶陵县
喀喇沁	喀喇沁旗
矿区	矿区
海兴	海兴县
临朐	临朐县
合川	合川区
桐城	桐城市
环翠	环翠区
蓝山	蓝山县
东河	东河区
河曲	河曲县
五通桥	五通桥区
贵南	贵南县
叠彩	叠彩区
灌云	灌云县
林周	林周县
卓资	卓资县
白云	白云区
市中	市中区
美姑	美姑县
贵德	贵德县
江安	江安县
治多	治多县
宣武	宣武区
东昌	东昌区
槐荫	槐荫区
建湖	建湖县
阳新	阳新县
于田	于田县
颍上	颍上县
平原	平原县
李沧	李沧区
德安	德安县
中阳	中阳县
元宝	元宝区
泉港	泉港区
洛江	洛江区
黎城	黎城县
龙港	龙港区
红原	红原县
掇刀	掇刀区
南漳	南漳县
市中	市中区
天长	天长市
定远	定远县
广饶	广饶县
鹿泉	鹿泉市
德保	德保县
壤塘	壤塘县
肥城	肥城市
七台河	七台河市
盐池	盐池县
德令哈	德令哈市
凌源	凌源市
绵竹	绵竹市
任城	任城区
马尾	马尾区
南票	南票区
雁江	雁江区
茌平	茌平县
松潘	松潘县
鄂伦春	鄂伦春自治旗
西夏	西夏区
献县	献县
忠县	忠县
惠农	惠农区
宁阳	宁阳县
南靖	南靖县
漳浦	漳浦县
诏安	诏安县
和静	和静县
小金	小金县
平潭	平潭县
罗源	罗源县
连江	连江县
忻府	忻府区
云安	云安县
芒康	芒康县
枞阳	枞阳县
陈仓	陈仓区
化德	化德县
老河口	老河口市
市中	市中区
都匀	都匀市
安龙	安龙县
北票	北票市
南芬	南芬区
老边	老边区
金秀	金秀瑶族自治县
乌尔禾	乌尔禾区
建昌	建昌县
绥中	绥中县
山阳	山阳县
洛南	洛南县
平利	平利县
眉县	眉县
金台	金台区
陇县	陇县
麟游	麟游县
吴起	吴起县
子长	子长县
乡城	乡城县
周至	周至县
灞桥	灞桥区
溧阳	溧阳市
宜城	宜城市
高陵	高陵县
城西	城西区
蓟县	蓟县
沧县	沧县
印台	印台区
玛多	玛多县
玛沁	玛沁县
班玛	班玛县
达日	达日县
乐都	乐都县
互助	互助土族自治县
化隆	化隆回族自治县
平安	平安县
刚察	刚察县
共和	共和县
兴海	兴海县
同德	同德县
桃山	桃山区
南岔	南岔区
友好	友好区
翠峦	翠峦区
莫旗	莫力达瓦达斡尔族自治旗
临河	临河区
肃宁	肃宁县
湟中	湟中县
岭东	岭东区
青冈	青冈县
班戈	班戈县
肃北	肃北蒙古族自治县
卢湾	卢湾区
浪卡子	浪卡子县
富拉尔基	富拉尔基区
富裕	富裕县
建华	建华区
昂昂溪	昂昂溪区
察右后旗	察哈尔右翼后旗
武昌	武昌区
恩施	恩施市
来凤	来凤县
昌江	昌江区
阳曲	阳曲县
三山	三山区
二连浩特	二连浩特市
射阳	射阳县
永登	永登县
河津	河津市
江城	江城区
荃湾	荃湾区
柳城	柳城县
东兴	东兴市
普安	普安县
扎兰屯	扎兰屯市
务川	务川仡佬族苗族自治县
桐梓	桐梓县
正安	正安县
婺源	婺源县
玉山	玉山县
都昌	都昌县
东湖	东湖区
汝阳	汝阳县
海晏	海晏县
贵溪	贵溪市
保德	保德县
偏关	偏关县
平武	平武县
清徐	清徐县
临漳	临漳县
仙居	仙居县
两当	两当县
平凉	平凉市
任县	任县
迭部	迭部县
会宁	会宁县
平川	平川区
富民	富民县
雷州	雷州市
康县	康县
文县	文县
盘山	盘山县
武穴	武穴市
蕲春	蕲春县
黄州	黄州区
桑植	桑植县
泸县	泸县
江川	江川县
麻城	麻城市
比如	比如县
申扎	申扎县
兴义	兴义市
华亭	华亭县
莘县	莘县
金口河	金口河区
香坊	香坊区
呼中	呼中区
珲春	珲春市
新右旗	新巴尔虎右旗
资中	资中县
林甸	林甸县
红岗	红岗区
肇州	肇州县
沙坡头	沙坡头区
清河	清河区
拜泉	拜泉县
沙依巴克	沙依巴克区
东宁	东宁县
四方	四方区
市北	市北区
江阳	江阳区
元江	元江县
鄂温旗	鄂温克族自治旗
大洼	大洼县
龙凤	龙凤区
歙县	歙县
普陀	普陀区
长宁	长宁区
裕安	裕安区
霍山	霍山县
包河	包河区
鸠江	鸠江区
临泉	临泉县
颍州	颍州区
当涂	当涂县
胶南	胶南市
花山	花山区
盱眙	盱眙县
金湖	金湖县
东台	东台市
响水	响水县
高新	高新区
东海	东海县
徽州	徽州区
河口	河口区
平邑	平邑县
青山湖	青山湖区
桦甸	桦甸市
沂南	沂南县
郯城	郯城县
庆云	庆云县
齐河	齐河县
东平	东平县
泰山	泰山区
泰和	泰和县
黄岩	黄岩区
南谯	南谯区
平阴	平阴县
寒亭	寒亭区
高密	高密市
临清	临清市
城阳	城阳区
安吉	安吉县
嵊州	嵊州市
修水	修水县
新昌	新昌县
永定	永定县
宛城	宛城区
新野	新野县
桐柏	桐柏县
邓州	邓州市
镇平	镇平县
隆林	隆林各族自治县
桂平	桂平市
扶沟	扶沟县
沈丘	沈丘县
永城	永城市
睢县	睢县
龙安	龙安区
舞阳	舞阳县
郾城	郾城区
南乐	南乐县
台前	台前县
清丰	清丰县
范县	范县
中站	中站区
修武	修武县
博爱	博爱县
沁阳	沁阳市
马村	马村区
长葛	长葛市
潘集	潘集区
灌南	灌南县
魏都	魏都区
上街	上街区
中原	中原区
金水	金水区
上蔡	上蔡县
正阳	正阳县
遂平	遂平县
驿城	驿城区
山城	山城区
浚县	浚县
丹江口	丹江口市
崇阳	崇阳县
余干	余干县
广丰	广丰县
德兴	德兴市
安陆	安陆市
滕州	滕州市
商河	商河县
宜都	宜都市
咸丰	咸丰县
蔡甸	蔡甸区
罗田	罗田县
石门	石门县
横峰	横峰县
湾里	湾里区
万安	万安县
蠡县	蠡县
黄梅	黄梅县
下陆	下陆区
双峰	双峰县
华容	华容县
安乡	安乡县
桃源	桃源县
汉寿	汉寿县
大厂	大厂回族自治县
安次	安次区
广阳	广阳区
文安	文安县
永清	永清县
津市	津市市
韶山	韶山市
保靖	保靖县
武冈	武冈市
洞口	洞口县
隆回	隆回县
嘉禾	嘉禾县
安仁	安仁县
望城	望城县
芙蓉	芙蓉区
望江	望江县
湖滨	湖滨区
殷都	殷都区
延庆	延庆县
大港	大港区
武清	武清区
岱岳	岱岳区
龙泉	龙泉市
天台	天台县
西青	西青区
西乌旗	西乌珠穆沁旗
东山	东山区
兴安	兴安区
慈溪	慈溪市
吉县	吉县
宁乡	宁乡县
尧都	尧都区
永和	永和县
浮山	浮山县
南郊	南郊区
五寨	五寨县
宁武	宁武县
向阳	向阳区
绥滨	绥滨县
逊克	逊克县
依安	依安县
克东	克东县
太谷	太谷县
平遥	平遥县
克山	克山县
昔阳	昔阳县
泽州	泽州县
右玉	右玉县
夏县	夏县
平陆	平陆县
新绛	新绛县
永济	永济市
曲阳	曲阳县
望都	望都县
绿园	绿园区
威远	威远县
布拖	布拖县
阜平	阜平县
滦县	滦县
路南	路南区
遵化	遵化市
三河	三河市
香河	香河县
宣化	宣化县
青浦	青浦区
鹰手营子	鹰手营子矿区
南皮	南皮县
运河	运河区
井陉矿	井陉矿区
沁源	沁源县
平乡	平乡县
广宗	广宗县
新河	新河县
高坪	高坪区
平山	平山县
晋州	晋州市
桥东	桥东区
桥西	桥西区
深泽	深泽县
合山	合山市
高邑	高邑县
安平	安平县
故城	故城县
阜城	阜城县
饶阳	饶阳县
南宫	南宫市
宁晋	宁晋县
巨鹿	巨鹿县
察右前旗	察哈尔右翼前旗
桥东	桥东区
清河	清河县
丛台	丛台区
复兴	复兴区
大名	大名县
峰峰矿	峰峰矿区
永年	永年县
邯山	邯山区
万江	万江区
东城	东城区
南城	南城区
莞城	莞城区
南安	南安市
安溪	安溪县
中山港	中山港
西区	西区
荔湾	荔湾区
惠东	惠东县
大埔	大埔县
台山	台山市
恩平	恩平市
新会	新会区
宁江	宁江区
新市	新市区
连山	连山区
木垒	木垒哈萨克自治县
江海	江海区
双辽	双辽市
乌什	乌什县
三台	三台县
西乡塘	西乡塘区
伽师	伽师县
邕宁	邕宁区
龙川	龙川县
福田	福田区
佛冈	佛冈县
阳山	阳山县
化州	化州市
高州	高州市
和县	和县
杜集	杜集区
镜湖	镜湖区
始兴	始兴县
曲江	曲江区
翁源	翁源县
扶绥	扶绥县
莒县	莒县
峄城	峄城区
钢城	钢城区
定陶	定陶县
城中	城中区
柳北	柳北区
柳南	柳南区
柳江	柳江县
临桂	临桂县
平乐	平乐县
凤山	凤山县
宜州	宜州市
环江	环江毛南族自治县
罗城	罗城仫佬族自治县
博白	博白县
陆川	陆川县
凌云	凌云县
田东	田东县
田阳	田阳县
五华	五华县
西林	西林县
矿区	矿区
阜南	阜南县
颍东	颍东区
昭平	昭平县
钟山	钟山县
钦北	钦北区
上思	上思县
灵丘	灵丘县
平远	平远县
金平	金平区
拱北	拱北区
阳西	阳西县
安源	安源区
莲花	莲花县
全南	全南县
沙田	沙田区
宝安	宝安区
盐田	盐田区
兴宾	兴宾区
南雄	南雄市
新丰	新丰县
阿克陶	阿克陶县
托克逊	托克逊县
良庆	良庆区
河间	河间市
融安	融安县
融水	融水苗族自治县
民丰	民丰县
东港	东港区
西湖	西湖区
进贤	进贤县
息县	息县
临城	临城县
临西	临西县
内丘	内丘县
钦南	钦南区
南和	南和县
达坂城	达坂城区
政和	政和县
光山	光山县
商城	商城县
巴里	巴里坤哈萨克自治县
叶城	叶城县
巴楚	巴楚县
滨城	滨城区
塔城	塔城市
库尔勒	库尔勒市
焉耆	焉耆回族自治县
高台	高台县
拱墅	拱墅区
淳安	淳安县
西华	西华县
越城	越城区
衢江	衢江区
长治	长治县
察布	察布查尔锡伯自治县
三原	三原县
旬邑	旬邑县
永寿	永寿县
汉川	汉川市
丰镇	丰镇市
凉城	凉城县
白碱滩	白碱滩区
南澳	南澳县
罗湖	罗湖区
平罗	平罗县
张家川	张家川回族自治县
秦州	秦州区
岷县	岷县
灵台	灵台县
西峰	西峰区
肃南	肃南裕固族自治县
新郑	新郑市
英吉沙	英吉沙县
和布克赛尔	和布克赛尔蒙古自治县
宕昌	宕昌县
通山	通山县
云梦	云梦县
临武	临武县
桂阳	桂阳县
横县	横县
册亨	册亨县
通化	通化县
沙湾	沙湾县
且末	且末县
阜康	阜康市
拜城	拜城县
柯坪	柯坪县
阿克苏	阿克苏市
兴平	兴平市
杨陵	杨陵区
阿瓦提	阿瓦提县
渭城	渭城区
礼泉	礼泉县
汉滨	汉滨区
白河	白河县
石泉	石泉县
镇坪	镇坪县
清河	清河区
建瓯	建瓯市
凤翔	凤翔县
渭滨	渭滨区
延川	延川县
延长	延长县
麦盖提	麦盖提县
乌苏	乌苏市
白水	白水县
和林格尔	和林格尔县
庆城	庆城县
费县	费县
萨嘎	萨嘎县
洛隆	洛隆县
沿滩	沿滩区
金沙	金沙县
云岩	云岩区
启东	启东市
六合	六合区
雨花台	雨花台区
高淳	高淳县
蒲城	蒲城县
如皋	如皋市
海安	海安县
仪征	仪征市
龙里	龙里县
云阳	云阳县
垫江	垫江县
丹阳	丹阳市
上饶	上饶县
信州	信州区
乌兰浩特	乌兰浩特市
嘉荫	嘉荫县
西林	西林区
奉节	奉节县
潼关	潼关县
澄城	澄城县
维西	维西县
分宜	分宜县
中牟	中牟县
景县	景县
开县	开县
沙坪坝	沙坪坝区
邹平	邹平县
阳谷	阳谷县
城区	城区
乐昌	乐昌市
曲水	曲水县
涪陵	涪陵区
墨脱	墨脱县
来安	来安县
河东	河东区
得荣	得荣县
石渠	石渠县
璧山	璧山县
庐江	庐江县
金坛	金坛市
石城	石城县
南市	南市区
安国	安国市
高阳	高阳县
路北	路北区
安县	安县
唐河	唐河县
万全	万全县
下花园	下花园区
石林	石林县
祥云	祥云县
岢岚	岢岚县
围场	围场满族蒙古族自治县
东光	东光县
新宁	新宁县
霍林郭勒	霍林郭勒市
灵寿	灵寿县
巫山	巫山县
增城	增城市
洮南	洮南市
靖宇	靖宇县
兖州	兖州市
嘉祥	嘉祥县
桓台	桓台县
固始	固始县
平桥	平桥区
浉河	浉河区
内乡	内乡县
龙亭	龙亭区
原阳	原阳县
禹城	禹城市
陵县	陵县
三门	三门县
临海	临海市
宁海	宁海县
临猗	临猗县
南华	南华县
绍兴	绍兴县
东阳	东阳市
房县	房县
郧西	郧西县
竹山	竹山县
枝江	枝江市
和平	和平区
新平	新平县
南城	南城县
广昌	广昌县
渝水	渝水区
揭西	揭西县
普宁	普宁市
鹤峰	鹤峰县
西塞山	西塞山区
娄星	娄星区
君山	君山区
湘阴	湘阴县
澧县	澧县
中方	中方县
靖州	靖州苗族侗族自治县
石峰	石峰区
邵东	邵东县
绿春	绿春县
神池	神池县
伊吾	伊吾县
吉木萨尔	吉木萨尔县
金川	金川区
将乐	将乐县
沙县	沙县
光泽	光泽县
凯里	凯里市
望谟	望谟县
贞丰	贞丰县
铁西	铁西区
木里	木里藏族自治县
甘洛	甘洛县
盐源	盐源县
惠安	惠安县
赤坎	赤坎区
天宁	天宁区
克拉玛依	克拉玛依区
博湖	博湖县
西昌	西昌市
金阳	金阳县
宏伟	宏伟区
乳山	乳山市
仪陇	仪陇县
顺庆	顺庆区
兴文	兴文县
江阴	江阴市
马山	马山县
哈密	哈密市
通江	通江县
裕民	裕民县
和硕	和硕县
冷湖	冷湖行委
元坝	元坝区
武胜	武胜县
侯马	侯马市
九里	九里区
罗江	罗江县
万柏林	万柏林区
绥芬河	绥芬河市
邳州	邳州市
巴青	巴青县
改则	改则县
革吉	革吉县
六枝特	六枝特区
万荣	万荣县
纳雍	纳雍县
织金	织金县
花溪	花溪区
开鲁	开鲁县
盐边	盐边县
米易	米易县
古蔺	古蔺县
丹巴	丹巴县
九龙	九龙县
丹棱	丹棱县
彭山	彭山县
永丰	永丰县
施秉	施秉县
古塔	古塔区
凤城	凤城市
庄河	庄河市
东洲	东洲区
新抚	新抚区
信丰	信丰县
荥阳	荥阳市
喀左	喀喇沁左翼蒙古族自治县
科左中旗	科尔沁左翼中旗
集安	集安市
贡井	贡井区
乐至	乐至县
万源	万源市
渠县	渠县
加查	加查县
太和	太和区
九寨沟	九寨沟县
理县	理县
康平	康平县
新民	新民市
磁县	磁县
通川	通川区
浏阳	浏阳市
邱县	邱县
青秀	青秀区
茂县	茂县
金川	金川县
马尔康	马尔康县
天全	天全县
西丰	西丰县
扎鲁特	扎鲁特旗
银州	银州区
墨竹县	墨竹工卡县
达孜	达孜县
亚东	亚东县
仁布	仁布县
象山	象山区
兴业	兴业县
吴川	吴川市
仲巴	仲巴县
吉隆	吉隆县
左贡	左贡县
贡觉	贡觉县
边坝	边坝县
港南	港南区
八步	八步区
察隅	察隅县
工布江达	工布江达县
朗县	朗县
佳县	佳县
府谷	府谷县
横山	横山县
清涧	清涧县
神木	神木县
米脂	米脂县
勉县	勉县
西秀	西秀区
镇宁	镇宁布依族苗族自治县
大方	大方县
上虞	上虞市
那曲	那曲县
宜君	宜君县
王益	王益区
耀州	耀州区
水城	水城县
平坝	平坝县
紫云	紫云苗族布依族自治县
海门	海门市
通州	通州市
南明	南明区
小河	小河区
开阳	开阳县
沙雅	沙雅县
都兰	都兰县
囊谦	囊谦县
曲麻莱	曲麻莱县
玉树	玉树县
称多	称多县
城中	城中区
城北	城北区
奎屯	奎屯市
清镇	清镇市
白云	白云区
余庆	余庆县
凤冈	凤冈县
汇川	汇川区
睢阳	睢阳区
兰考	兰考县
东乌旗	东乌珠穆沁旗
乌恰	乌恰县
瓜州	瓜州县
尤溪	尤溪县
永安	永安市
习水	习水县
清流	清流县
寿宁	寿宁县
芦山	芦山县
湄潭	湄潭县
红花岗	红花岗区
长岭	长岭县
临沭	临沭县
阿左旗	阿拉善左旗
松桃	松桃苗族自治县
石阡	石阡县
铜仁	铜仁市
三穗	三穗县
丹寨	丹寨县
剑河	剑河县
岑巩	岑巩县
宜章	宜章县
泗阳	泗阳县
麻江	麻江县
罗甸	罗甸县
荔波	荔波县
兴仁	兴仁县
沿河	沿河土家族自治县
单县	单县
巨野	巨野县
二七	二七区
南部	南部县
通榆	通榆县
铁东	铁东区
向阳	向阳区
桦川	桦川县
汤原	汤原县
郊区	郊区
姜堰	姜堰市
桂东	桂东县
行唐	行唐县
道外	道外区
阜宁	阜宁县
芦淞	芦淞区
阿城	阿城区
冕宁	冕宁县
封开	封开县
昆山	昆山市
肇源	肇源县
萨尔图	萨尔图区
吉安	吉安县
东安	东安区
海伦	海伦市
潢川	潢川县
大悟	大悟县
桃江	桃江县
晴隆	晴隆县
资阳	资阳区
港口	港口区
通渭	通渭县
平谷	平谷区
东陵	东陵区
于洪	于洪区
连州	连州市
迎江	迎江区
谢家集	谢家集区
青原	青原区
昌乐	昌乐县
阿右旗	阿拉善右旗
新兴	新兴区
闵行	闵行区
西城	西城区
北碚	北碚区
勃利	勃利县
洛川	洛川县
泽库	泽库县
茄子河	茄子河区
上甘岭	上甘岭区
郊区	郊区
浔阳	浔阳区
旬阳	旬阳县
湖口	湖口县
新建	新建县
鄂托克旗	鄂托克旗
左权	左权县
荣成	荣成市
崇仁	崇仁县
应县	应县
八道江	八道江区
溧水	溧水县
张湾	张湾区
鄂托克前旗	鄂托克前旗
龙口	龙口市
临夏	临夏市
图们	图们市
龙井	龙井市
金州	金州区
长海	长海县
望花	望花区
开原	开原市
美溪	美溪区
东风	东风区
友谊	友谊县
金山屯	金山屯区
城子河	城子河区
龙江	龙江县
龙沙	龙沙区
东坡	东坡区
蒙城	蒙城县
居巢	居巢区
杏花岭	杏花岭区
安远	安远县
定南	定南县
霍邱	霍邱县
庐阳	庐阳区
太湖	太湖县
潜山	潜山县
莱西	莱西市
楚州	楚州区
上高	上高县
丰城	丰城市
铜鼓	铜鼓县
高安	高安市
金溪	金溪县
兴国	兴国县
寻乌	寻乌县
崇义	崇义县
宁都	宁都县
磐安	磐安县
金东	金东区
双滦	双滦区
邵武	邵武市
蕉城	蕉城区
郏县	郏县
龙海	龙海市
仓山	仓山区
长乐	长乐市
大通	大通区
卫东	卫东区
叶县	叶县
宝丰	宝丰县
鲁山	鲁山县
尉氏	尉氏县
开封	开封县
杞县	杞县
通许	通许县
顺河	顺河区
鼓楼	鼓楼区
卫滨	卫滨区
延津	延津县
获嘉	获嘉县
伊川	伊川县
栾川	栾川县
洛宁	洛宁县
瀍河	瀍河区
章贡	章贡区
海陵	海陵区
建始	建始县
东西湖	东西湖区
麻阳	麻阳苗族自治县
天元	天元区
攸县	攸县
荷塘	荷塘区
湘潭	湘潭县
无为	无为县
郊区	郊区
祁门	祁门县
湛河	湛河区
花垣	花垣县
龙山	龙山县
南县	南县
钟祥	钟祥市
枣阳	枣阳市
曾都	曾都区
门头沟	门头沟区
醴陵	醴陵市
冷水滩	冷水滩区
翼城	翼城县
襄汾	襄汾县
霍州	霍州市
交口	交口县
交城	交城县
汤阴	汤阴县
方山	方山县
左云	左云县
新荣	新荣区
古交	古交市
城区	城区
屯留	屯留县
滑县	滑县
武乡	武乡县
沁县	沁县
郊区	郊区
长子	长子县
徐水	徐水县
雄县	雄县
顺平	顺平县
高碑店	高碑店市
丰润	丰润区
乐亭	乐亭县
滦南	滦南县
东乡	东乡县
卫辉	卫辉市
吉利	吉利区
嵩县	嵩县
崇礼	崇礼县
康保	康保县
张北	张北县
阳原	阳原县
孟津	孟津县
新安	新安县
洛龙	洛龙区
滦平	滦平县
武邑	武邑县
深州	深州市
泗县	泗县
成安	成安县
曲周	曲周县
泰兴	泰兴市
宝应	宝应县
桂山	桂山
樊城	樊城区
鹤山	鹤山市
永兴	永兴县
资兴	资兴市
开福	开福区
潮南	潮南区
鼎湖	鼎湖区
清城	清城区
湘桥	湘桥区
潮安	潮安县
端州	端州区
高要	高要市
孟村	孟村回族自治县
固镇	固镇县
永福	永福县
灵川	灵川县
长洲	长洲区
怀安	怀安县
巴马	巴马瑶族自治县
贵池	贵池区
怀远	怀远县
观塘	观塘区
黄大仙	黄大仙区
利通	利通区
青铜峡	青铜峡市
万年	万年县
微山	微山县
奉化	奉化市
周村	周村区
高青	高青县
无棣	无棣县
沾化	沾化县
丰满	丰满区
米泉	米泉市
细河	细河区
立山	立山区
鸡泽	鸡泽县
昌邑	昌邑区
吉州	吉州区
稷山	稷山县
招远	招远市
猇亭	猇亭区
潍城	潍城区
西固	西固区
清水	清水县
陇西	陇西县
庄浪	庄浪县
舟曲	舟曲县
阿克塞	阿克塞哈萨克族自治县
黄龙	黄龙县
定边	定边县
南郑	南郑县
富平	富平县
循化	循化撒拉族自治县
民和	民和回族土族自治县
祁连	祁连县
伊春	伊春区
新青	新青区
汤旺河	汤旺河区
红星	红星区
大武口	大武口区
四方台	四方台区
门源	门源回族自治县
乌兰	乌兰县
大柴旦	大柴旦行委
天峻	天峻县
杂多	杂多县
云和	云和县
利川	利川市
宣恩	宣恩县
西区	西区
千山	千山区
松山	松山区
头屯河	头屯河区
安定	安定区
漳县	漳县
崆峒	崆峒区
崇信	崇信县
东至	东至县
精河	精河县
大安	大安市
长清	长清区
丹徒	丹徒区
瑞昌	瑞昌市
青云谱	青云谱区
江津	江津区
当雄	当雄县
唐县	唐县
东阿	东阿县
聂拉木	聂拉木县
埇桥	埇桥区
武城	武城县
鄱阳	鄱阳县
袁州	袁州区
潼南	潼南县
泾县	泾县
抚松	抚松县
涞源	涞源县
靖远	靖远县
黔江	黔江区
丁青	丁青县
工业园	工业园区
永修	永修县
金明	金明区
集贤	集贤县
江口	江口县
玉屏	玉屏侗族自治县
乐安	乐安县
饶河	饶河县
巍山	巍山县
永平	永平县
平山	平山区
郓城	郓城县
长顺	长顺县
五常	五常市
依兰	依兰县
平顺	平顺县
江城	江城县
三江	三江侗族自治县
大东	大东区
法库	法库县
皇姑	皇姑区
苏家屯	苏家屯区
辽中	辽中县
双台子	双台子区
双清	双清区
盂县	盂县
从化	从化市
宿城	宿城区
西盟	西盟县
天等	天等县
黑山	黑山县
确山	确山县
安宁	安宁区
盐津	盐津县
沭阳	沭阳县
宜兴	宜兴市
夷陵	夷陵区
贾汪	贾汪区
海沧	海沧区
福安	福安市
福鼎	福鼎市
牧野	牧野区
鄢陵	鄢陵县
定海	定海区
峨山	峨山县
巩义	巩义市
会理	会理县
巴彦	巴彦县
荔城	荔城区
漳平	漳平市
盐都	盐都区
丘北	丘北县
大荔	大荔县
昭觉	昭觉县
余江	余江县
月湖	月湖区
普格	普格县
商都	商都县
林西	林西县
巫溪	巫溪县
阳明	阳明区
肇东	肇东市
兴和	兴和县
惠阳	惠阳区
惠来	惠来县
金门	金门县
上林	上林县
武功	武功县
泾阳	泾阳县
大埔	大埔区
淳化	淳化县
绥江	绥江县
屏山	屏山县
栖霞	栖霞市
丰县	丰县
睢宁	睢宁县
惠济	惠济区
濮阳	濮阳县
根河	根河市
阿荣	阿荣旗
乐陵	乐陵市
岚山	岚山区
郎溪	郎溪县
万载	万载县
奉新	奉新县
黟县	黟县
苍山	苍山县
大宁	大宁县
安泽	安泽县
曲沃	曲沃县
苍梧	苍梧县
蝶山	蝶山区
富川	富川瑶族自治县
浦北	浦北县
灵山	灵山县
和政	和政县
榆中	榆中县
乌中旗	乌拉特中旗
额尔古纳	额尔古纳市
叙永	叙永县
纳溪	纳溪区
苍溪	苍溪县
浦口	浦口区
朝天	朝天区
涡阳	涡阳县
巴塘	巴塘县
甘孜	甘孜县
稻城	稻城县
色达	色达县
雅江	雅江县
裕华	裕华区
辛集	辛集市
昌黎	昌黎县
青龙	青龙满族自治县
枣强	枣强县
武强	武强县
天峨	天峨县
北流	北流市
沂水	沂水县
盐山	盐山县
防城	防城区
东山	东山区
梓潼	梓潼县
涪城	涪城区
大安	大安区
安居	安居区
同心	同心县
虎林	虎林市
鸡东	鸡东县
麻山	麻山区
南山	南山区
弋江	弋江区
芜湖	芜湖县
狮子山	狮子山区
界首	界首市
东营	东营区
新泰	新泰市
历城	历城区
曲阜	曲阜市
泗水	泗水县
江干	江干区
四会	四会市
福山	福山区
东明	东明县
新华	新华区
成武	成武县
即墨	即墨市
崂山	崂山区
秭归	秭归县
巴东	巴东县
黄陂	黄陂区
南康	南康市
沙市	沙市区
顺德	顺德区
越秀	越秀区
铜官山	铜官山区
市中	市中区
汶上	汶上县
市南	市南区
闻喜	闻喜县
汉源	汉源县
银海	银海区
龙岗	龙岗区
江华	江华瑶族自治县
海城	海城区
贡嘎	贡嘎县
新林	新林区
虞城	虞城县
内黄	内黄县
北关	北关区
科尔沁	科尔沁区
平果	平果县
田林	田林县
那坡	那坡县
平南	平南县
乾安	乾安县
盘县	盘县
普定	普定县
德清	德清县
石龙	石龙区
禹王台	禹王台区
索县	索县
泌阳	泌阳县
西平	西平县
特克斯	特克斯县
堆龙德庆	堆龙德庆县
黄平	黄平县
黎平	黎平县
平塘	平塘县
独山	独山县
福泉	福泉市
沙河口	沙河口区
井研	井研县
诸城	诸城市
瓦房店	瓦房店市
定结	定结县
岗巴	岗巴县
聂荣	聂荣县
措勤	措勤县
石台	石台县
八公山	八公山区
五河	五河县
高明	高明区
全州	全州县
金家庄	金家庄区
屯溪	屯溪区
突泉	突泉县
离石	离石区
迎泽	迎泽区
静乐	静乐县
定兴	定兴县
容城	容城县
新市	新市区
迁西	迁西县
固安	固安县
大城	大城县
沛县	沛县
鹿邑	鹿邑县
白云矿	白云矿区
德江	德江县
思南	思南县
正镶白	正镶白旗
苏右旗	苏尼特右旗
苏左旗	苏尼特左旗
长安	长安区
灵宝	灵宝市
蒸湘	蒸湘区
多伦	多伦县
铁西	铁西区
汪清	汪清县
南召	南召县
卧龙	卧龙区
乡宁	乡宁县
郸城	郸城县
衡山	衡山县
宁县	宁县
理塘	理塘县
南岗	南岗区
疏附	疏附县
莎车	莎车县
林口	林口县
海林	海林市
西畴	西畴县
曹县	曹县
竹溪	竹溪县
茅箭	茅箭区
郧县	郧县
云霄	云霄县
寿光	寿光市
昌邑	昌邑市
青州	青州市
镇康	镇康县
龙湖	龙湖区
都安	都安瑶族自治县
玉州	玉州区
鲤城	鲤城区
莱山	莱山区
武隆	武隆县
翁牛特	翁牛特旗
德惠	德惠市
沐川	沐川县
越西	越西县
祁东	祁东县
港闸	港闸区
广汉	广汉市
高港	高港区
静宁	静宁县
华池	华池县
合水	合水县
谯城	谯城区
西吉	西吉县
肥东	肥东县
长丰	长丰县
大观	大观区
全椒	全椒县
太和	太和县
利津	利津县
马关	马关县
梁山	梁山县
连山	连山壮族瑶族自治县
大姚	大姚县
察雅	察雅县
双湖	双湖特别区
鹿寨	鹿寨县
旅顺口	旅顺口区
喀什	喀什市
塔什县	塔什库尔干塔吉克自治县
岳普湖	岳普湖县
泽普	泽普县
桥西	桥西区
淮阴	淮阴区
京口	京口区
句容	句容市
宁强	宁强县
汉台	汉台区
于都	于都县
会昌	会昌县
隆尧	隆尧县
代县	代县
呈贡	呈贡县
老城	老城区
管城	管城区
淇县	淇县
北仑	北仑区
海曙	海曙区
龙湾	龙湾区
普陀	普陀区
开化	开化县
柯城	柯城区
江山	江山市
酉阳	酉阳土家族苗族自治县
昌宁	昌宁县
保康	保康县
寻甸	寻甸县
铁山	铁山区
姚安	姚安县
五大连池	五大连池市
北安	北安市
科右前旗	科尔沁右翼前旗
土左旗	土默特左旗
托克托	托克托县
新蔡	新蔡县
洮北	洮北区
东辽	东辽县
蒲县	蒲县
隰县	隰县
京山	京山县
阆中	阆中市
措美	措美县
珙县	珙县
阿巴嘎	阿巴嘎旗
东区	东区
遵义	遵义县
万山	万山特区
中山	中山区
文水	文水县
唐海	唐海县
禹会	禹会区
蚌山	蚌山区
颍泉	颍泉区
敖汉	敖汉旗
杭锦	杭锦旗
青川	青川县
邻水	邻水县
阿图什	阿图什市
康乐	康乐县
积石山	积石山保安族东乡族撒拉族自治县
馆陶	馆陶县
宁安	宁安市
工农	工农区
建邺	建邺区
江孜	江孜县
铁力	铁力市
解放	解放区
平舆	平舆县
未央	未央区
久治	久治县
前进	前进区
讷河	讷河市
屯门	屯门区
秀山	秀山土家族苗族自治县
尚志	尚志市
汾阳	汾阳市
梅江	梅江区
黔南	黔南布依族苗族自治州
南涧	南涧县
鲁甸	鲁甸县
额济纳	额济纳旗
和田	和田地区
乌达	乌达区
章丘	章丘市
海原	海原县
市中	市中区
薛城	薛城区
济阳	济阳县
淄川	淄川区
坊子	坊子区
莱阳	莱阳市
蓬莱	蓬莱市
萝岗	萝岗区
会东	会东县
喜德	喜德县
垦利	垦利县
金湾	金湾区
万秀	万秀区
岑溪	岑溪市
大化	大化瑶族自治县
船营	船营区
覃塘	覃塘区
岐山	岐山县
巴州	巴州区
德城	德城区
温泉	温泉县
策勒	策勒县
疏勒	疏勒县
潞城	潞城市
东区	东区
环城	环城
云城	云城区
尉犁	尉犁县
龙马潭	龙马潭区
峡江	峡江县
北市	北市区
丰南	丰南区
古冶	古冶区
玉田	玉田县
新华	新华区
新华	新华区
栾城	栾城县
项城	项城市
封丘	封丘县
红旗	红旗区
西工	西工区
临颍	临颍县
莲都	莲都区
遂昌	遂昌县
瑞安	瑞安市
瓯海	瓯海区
南浔	南浔区
诸暨	诸暨市
应城	应城市
伍家岗	伍家岗区
青山区	青山区
沙洋	沙洋县
襄城	襄城区
襄阳	襄阳区
谷城	谷城县
东昌府	东昌府区
绥阳	绥阳县
江永	江永县
岳塘	岳塘区
碌曲	碌曲县
玉门	玉门市
肃州	肃州区
建宁	建宁县
上杭	上杭县
道真	道真仡佬族苗族自治县
新罗	新罗区
隆子	隆子县
城关	城关区
烈山	烈山区
邯郸	邯郸县
紫阳	紫阳县
千阳	千阳县
民权	民权县
白朗	白朗县
波密	波密县
吴兴	吴兴区
安多	安多县
尼玛	尼玛县
蒙阴	蒙阴县
钟山	钟山区
雷山	雷山县
惠水	惠水县
龙城	龙城区
梁子湖	梁子湖区
鄂城	鄂城区
新田	新田县
塘沽	塘沽区
宁陕	宁陕县
岚皋	岚皋县
汉阴	汉阴县
安塞	安塞县
甘泉	甘泉县
宁化	宁化县
新城	新城区
秀屿	秀屿区
祁县	祁县
茫崖	茫崖行委
谢通门	谢通门县
乌伊岭	乌伊岭区
同仁	同仁县
尖扎	尖扎县
河南	河南蒙古族自治县
武宁	武宁县
宝清	宝清县
宾县	宾县
资源	资源县
雁山	雁山区
嘉黎	嘉黎县
塔河	塔河县
松岭	松岭区
龙胜	龙胜各族自治县
深水埗	深水埗区
漠河	漠河县
南湖	南湖区
红安	红安县
兰西	兰西县
北林	北林区
庆安	庆安县
明水	明水县
望奎	望奎县
托里	托里县
额敏	额敏县
高唐	高唐县
绥棱	绥棱县
密山	密山市
梨树	梨树区
滴道	滴道区
晋江	晋江市
梅里斯	梅里斯达斡尔族区
泰来	泰来县
甘南	甘南县
碾子山	碾子山区
隆化	隆化县
甘德	甘德县
莱城	莱城区
城步	城步自治县
大祥	大祥区
古田	古田县
涵江	涵江区
轮台	轮台县
孟连	孟连县
札达	札达县
德昌	德昌县
黄岛	黄岛区
盐亭	盐亭县
栖霞	栖霞区
江宁	江宁区
旺苍	旺苍县
博野	博野县
龙游	龙游县
点军	点军区
元朗	元朗区
市中	市中区
大新	大新县
华蓥	华蓥市
集宁	集宁区
海南	海南区
舒兰	舒兰市
龙潭	龙潭区
梨树	梨树县
安图	安图县
桥西	桥西区
柳河	柳河县
二道	二道区
双阳	双阳区
宽城	宽城区
西充	西充县
旌阳	旌阳区
荣县	荣县
简阳	简阳市
舒城	舒城县
彭阳	彭阳县
汶川	汶川县
旌德	旌德县
蓬江	蓬江区
东源	东源县
阳东	阳东县
浈江	浈江区
合浦	合浦县
铁山港	铁山港区
宁明	宁明县
皮山	皮山县
鼓楼	鼓楼区
若羌	若羌县
玛纳斯	玛纳斯县
温宿	温宿县
新沂	新沂市
广陵	广陵区
清浦	清浦区
相城	相城区
金阊	金阊区
海州	海州区
宜黄	宜黄县
上栗	上栗县
湘东	湘东区
芦溪	芦溪县
涿州	涿州市
无极	无极县
淮滨	淮滨县
商水	商水县
太康	太康县
夏邑	夏邑县
宁陵	宁陵县
柘城	柘城县
文峰	文峰区
新乡	新乡县
长垣	长垣县
鄞州	鄞州区
镇海	镇海区
建德	建德市
中西	中西区
恒山	恒山区
西安	西安区
承德	承德县
南昌	南昌县
九江	九江县
武夷山	武夷山市
大同	大同区
八宿	八宿县
柳林	柳林县
长泰	长泰县
昂仁	昂仁县
民乐	民乐县
沙湾	沙湾区
辉南	辉南县
新城	新城区
洪泽	洪泽县
吴江	吴江市
赣榆	赣榆县
沾益	沾益县
蓬溪	蓬溪县
名山	名山县
宁远	宁远县
安新	安新县
通道	通道侗族自治县
都江堰	都江堰市
蒲江	蒲江县
长安	长安区
惠城	惠城区
龙华	龙华区
蓝田	蓝田县
罗山	罗山县
白塔	白塔区
岱山	岱山县
桐庐	桐庐县
象山	象山县
西湖	西湖区
宜宾	宜宾市
顺义	顺义区
巴彦淖尔	巴彦淖尔市
曲靖	曲靖市
周口	周口市
阳泉	阳泉市
淮北	淮北市
石景山	石景山区
留坝	留坝县
弋阳	弋阳县
兴山	兴山县
翔安	翔安区
沁水	沁水县
呼和浩特	呼和浩特市
呼图壁	呼图壁县
赵县	赵县
前郭县	前郭尔罗斯蒙古族自治县
朝阳	朝阳县
焦作	焦作市
阿拉尔	阿拉尔市
清水河	清水河县
琼中	琼中黎族苗族自治县
德州	德州市
双流	双流县
海丰	海丰县
永康	永康市
上海	上海市
南阳	南阳市
乐山	乐山市
佛山	佛山市
鹰潭	鹰潭市
当阳	当阳市
灌阳	灌阳县
巴中	巴中市
双塔	双塔区
阳高	阳高县
大兴安岭	大兴安岭地区
宁波	宁波市
铁锋	铁锋区
平阳	平阳县
虎丘	虎丘区
寿县	寿县
城区	城区
汕头	汕头市
邵阳	邵阳县
昆明	昆明市
武汉	武汉市
洛阳	洛阳市
崇州	崇州市
杜尔伯特	杜尔伯特蒙古族自治县
崇明	崇明县
甘孜	甘孜州
登封	登封市
日喀则	日喀则地区
舟山	舟山市
肇庆	肇庆市
江北	江北区
唐山	唐山市
襄樊	襄樊市
余姚	余姚市
英德	英德市
白下	白下区
双牌	双牌县
吉水	吉水县
平顶山	平顶山市
湟源	湟源县
城固	城固县
铅山	铅山县
田家庵	田家庵区
资溪	资溪县
河北	河北省
长宁	长宁县
布尔津	布尔津县
梧州	梧州市
隆阳	隆阳区
阳春	阳春市
滨海	滨海县
岫岩	岫岩满族自治县
常州	常州市
凤台	凤台县
太仓	太仓市
锦江	锦江区
北海	北海市
丰台	丰台区
什邡	什邡市
七星	七星区
大庆	大庆市
嫩江	嫩江县
白山	白山市
永靖	永靖县
濠江	濠江区
扎囊	扎囊县
萍乡	萍乡市
荔浦	荔浦县
九龙坡	九龙坡区
隆安	隆安县
亳州	亳州市
南木林	南木林县
青山区	青山区
隆德	隆德县
恩施	恩施州
霞浦	霞浦县
耿马	耿马县
吴堡	吴堡县
兰坪	兰坪县
承德	承德市
建平	建平县
甘南	甘南藏族自治州
黑龙江	黑龙江省
麻章	麻章区
海南	海南省
宁夏	宁夏回族自治区
浦城	浦城县
潞西	潞西市
孟州	孟州市
夹江	夹江县
上城	上城区
景东	景东县
民勤	民勤县
北辰	北辰区
茂南	茂南区
东莞	东莞市
梁平	梁平县
泰州	泰州市
清远	清远市
乌审	乌审旗
许昌	许昌市
邢台	邢台市
勐海	勐海县
齐齐哈尔	齐齐哈尔市
山阴	山阴县
洛扎	洛扎县
宿州	宿州市
硚口	硚口区
宝山	宝山区
黄冈	黄冈市
綦江	綦江县
凭祥	凭祥市
宜良	宜良县
彭泽	彭泽县
雅安	雅安市
嘉鱼	嘉鱼县
安福	安福县
小店	小店区
大关	大关县
福海	福海县
合作	合作市
安宁	安宁市
甘井子	甘井子区
邗江	邗江区
林芝	林芝县
东川	东川区
公安	公安县
沈北新	沈北新区
来宾	来宾市
金堂	金堂县
乐业	乐业县
乾县	乾县
宿豫	宿豫区
陇南	陇南市
澄海	澄海区
平度	平度市
锡山	锡山区
鲅鱼圈	鲅鱼圈区
朔州	朔州市
泰顺	泰顺县
防城港	防城港市
三明	三明市
郊区	郊区
武宣	武宣县
潜江	潜江市
新密	新密市
漯河	漯河市
永顺	永顺县
牡丹江	牡丹江市
坡头	坡头区
马龙	马龙县
兴隆台	兴隆台区
七里河	七里河区
株洲	株洲市
孝昌	孝昌县
东兰	东兰县
樟树	樟树市
九台	九台市
河口瑶族自治县	河口县
湖州	湖州市
赫章	赫章县
天柱	天柱县
衡东	衡东县
济宁	济宁市
赣县	赣县
呼兰	呼兰区
星子	星子县
赛罕	赛罕区
玉龙	玉龙县
满洲里	满洲里市
宁洱	宁洱县
大理	大理市
电白	电白县
渑池	渑池县
和龙	和龙市
临高	临高县
海淀	海淀区
博山	博山区
桑日	桑日县
成华	成华区
铜陵	铜陵县
福清	福清市
海东	海东地区
松江	松江区
新余	新余市
仙游	仙游县
九江	九江市
宽甸	宽甸满族自治县
贵州	贵州省
天山	天山区
长汀	长汀县
江陵	江陵县
甘肃	甘肃省
黄陵	黄陵县
陵川	陵川县
江夏	江夏区
华安	华安县
榆林	榆林市
右江	右江区
成县	成县
万宁	万宁市
和顺	和顺县
武山	武山县
盘锦	盘锦市
剑阁	剑阁县
清苑	清苑县
犍为	犍为县
翠屏	翠屏区
富蕴	富蕴县
玉林	玉林市
澜沧	澜沧县
鹿城	鹿城区
聊城	聊城市
历下	历下区
台安	台安县
黄山	黄山区
吴中	吴中区
青白江	青白江区
南山	南山区
大兴	大兴区
新北	新北区
勐腊	勐腊县
池州	池州市
红山	红山区
哈密	哈密地区
斗门	斗门区
杨浦	杨浦区
赣州	赣州市
秀峰	秀峰区
南岸	南岸区
遂川	遂川县
东方	东方市
青田	青田县
北湖	北湖区
振安	振安区
抚顺	抚顺市
海南州	海南藏族自治州
乌鲁木齐	乌鲁木齐县
沧源	沧源县
邯郸	邯郸市
盈江	盈江县
福建	福建省
类乌齐	类乌齐县
延安	延安市
安康	安康市
宝塔	宝塔区
霞山	霞山区
陆丰	陆丰市
江西	江西省
武义	武义县
藁城	藁城市
麦积	麦积区
绍兴	绍兴市
新津	新津县
兰山	兰山区
荥经	荥经县
雨山	雨山区
双鸭山	双鸭山市
灵石	灵石县
蛟河	蛟河市
琼海	琼海市
五指山	五指山市
徐州	徐州市
中卫	中卫市
莆田	莆田市
利辛	利辛县
莱芜	莱芜市
延边	延边朝鲜族自治州
海宁	海宁市
扶风	扶风县
天水	天水市
广州	广州市
秦皇岛	秦皇岛市
银川	银川市
瑞丽	瑞丽市
香洲	香洲区
武川	武川县
峨眉山	峨眉山市
忻州	忻州市
商州	商州区
伊犁	伊犁哈萨克自治州
筠连	筠连县
文圣	文圣区
六盘水	六盘水市
黄山	黄山市
清新	清新县
河东	河东区
西安	西安市
亭湖	亭湖区
伊金旗	伊金霍洛旗
泸定	泸定县
珠海	珠海市
泊头	泊头市
揭阳	揭阳市
庆元	庆元县
蚌埠	蚌埠市
宁德	宁德市
古丈	古丈县
通化	通化市
绥化	绥化市
随州	随州市
镇远	镇远县
永泰	永泰县
嵩明	嵩明县
宜春	宜春市
丰都	丰都县
海西	海西蒙古族藏族自治州
元阳	元阳县
湖里	湖里区
阿勒泰	阿勒泰市
花都	花都区
永定	永定区
云浮	云浮市
原平	原平市
汾西	汾西县
天心	天心区
天河	天河区
博乐	博乐市
维扬	维扬区
安徽	安徽省
泾源	泾源县
游仙	游仙区
神农架	神农架林区
德宏	德宏傣族景颇族自治州
兴安盟	兴安盟
金牛	金牛区
海盐	海盐县
上犹	上犹县
礼县	礼县
锦州	锦州市
酒泉	酒泉市
沂源	沂源县
太白	太白县
靖边	靖边县
集美	集美区
淮阳	淮阳县
绥宁	绥宁县
凌海	凌海市
西南中沙群岛办事处	西南中沙群岛办事处
梅县	梅县
永嘉	永嘉县
洱源	洱源县
城口	城口县
钦州	钦州市
镇江	镇江市
广东	广东省
赤峰	赤峰市
临沂	临沂市
濉溪	濉溪县
新源	新源县
阳江	阳江市
景洪	景洪市
芜湖	芜湖市
陆良	陆良县
永州	永州市
船山	船山区
秦安	秦安县
辽阳	辽阳市
团风	团风县
保定	保定市
巴音郭楞	巴音郭楞蒙古自治州
辽宁	辽宁省
阳朔	阳朔县
佳木斯	佳木斯市
盘龙	盘龙区
陈巴尔虎	陈巴尔虎旗
易门	易门县
洪江	洪江市
原州	原州区
高县	高县
石狮	石狮市
下关	下关区
弓长岭	弓长岭区
岳池	岳池县
让胡路	让胡路区
南长	南长区
临湘	临湘市
义马	义马市
菏泽	菏泽市
定安	定安县
港北	港北区
平湖	平湖市
南关	南关区
潍坊	潍坊市
龙泉驿	龙泉驿区
新乐	新乐市
邛崃	邛崃市
方城	方城县
户县	户县
乌兰察布	乌兰察布市
闽侯	闽侯县
万州	万州区
毕节	毕节地区
上饶	上饶市
临安	临安市
海珠	海珠区
噶尔	噶尔县
宜昌	宜昌市
沧州	沧州市
伊宁	伊宁市
壶关	壶关县
自流井	自流井区
阳城	阳城县
偃师	偃师市
长沙	长沙县
长白	长白朝鲜族自治县
三亚	三亚市
介休	介休市
石楼	石楼县
略阳	略阳县
娄底	娄底市
正定	正定县
营口	营口市
大通	大通回族土族自治县
毕节	毕节市
木兰	木兰县
雁峰	雁峰区
奇台	奇台县
滨湖	滨湖区
北镇	北镇市
北戴河	北戴河区
宁蒗	宁蒗县
昆都仑	昆都仑区
弥渡	弥渡县
哈巴河	哈巴河县
德庆	德庆县
南沙	南沙区
靖江	靖江市
太子河	太子河区
朝阳	朝阳区
百色	百色市
凉州	凉州区
剑川	剑川县
茂港	茂港区
南陵	南陵县
罗定	罗定市
和田	和田市
烟台	烟台市
天桥	天桥区
江北	江北区
苏州	苏州市
湖南	湖南省
平江	平江区
东胜	东胜区
彬县	彬县
武安	武安市
中江	中江县
缙云	缙云县
喀什	喀什地区
澄迈	澄迈县
榕江	榕江县
海阳	海阳市
自贡	自贡市
石嘴山	石嘴山市
普兰店	普兰店市
康马	康马县
双桥	双桥区
海勃湾	海勃湾区
儋州	儋州市
水富	水富县
乃东	乃东县
牙克石市	牙克石市
永德	永德县
崇安	崇安区
汕尾	汕尾市
陇川	陇川县
乌当	乌当区
三元	三元区
昌都	昌都县
德阳	德阳市
美兰	美兰区
商洛	商洛市
宜川	宜川县
永吉	永吉县
涞水	涞水县
北川	北川羌族自治县
婺城	婺城区
嘉善	嘉善县
博兴	博兴县
耒阳	耒阳市
雨城	雨城区
泾川	泾川县
松溪	松溪县
新界	新界
峨边	峨边彝族自治县
克拉玛依	克拉玛依市
下城	下城区
普洱	普洱市
信宜	信宜市
阿里	阿里地区
永川	永川区
钟楼	钟楼区
汉沽	汉沽区
准格尔	准格尔旗
炉霍	炉霍县
惠州	惠州市
黑河	黑河市
临汾	临汾市
鱼峰	鱼峰区
九龙	九龙城区
浙江	浙江省
宣城	宣城市
石柱	石柱土家族自治县
锦屏	锦屏县
阿坝	阿坝州
奈曼	奈曼旗
万盛	万盛区
新干	新干县
渭源	渭源县
玉树	玉树藏族自治州
石拐	石拐区
苏仙	苏仙区
扎赉特	扎赉特旗
朝阳	朝阳市
蔚县	蔚县
洪洞	洪洞县
安义	安义县
长阳	长阳土家族自治县
常德	常德市
鼓楼	鼓楼区
兴庆	兴庆区
五华	五华区
新浦	新浦区
绛县	绛县
沈河	沈河区
仙桃	仙桃市
驻马店	驻马店市
本溪	本溪满族自治县
珠山	珠山区
宜阳	宜阳县
戚墅堰	戚墅堰区
文登	文登市
徽县	徽县
嘉兴	嘉兴市
金昌	金昌市
兴隆	兴隆县
古县	古县
宁城	宁城县
洋县	洋县
四平	四平市
丹凤	丹凤县
漾濞	漾濞县
贺州	贺州市
益阳	益阳市
古浪	古浪县
忻城	忻城县
青县	青县
新县	新县
无锡	无锡市
威海	威海市
濮阳	濮阳市
松阳	松阳县
滁州	滁州市
梅列	梅列区
安阳	安阳县
皋兰	皋兰县
湘潭	湘潭市
蒙山	蒙山县
包头	包头市
射洪	射洪县
泸西	泸西县
昭通	昭通市
阿坝	阿坝县
临洮	临洮县
开封	开封市
榆社	榆社县
晋宁	晋宁县
岳麓	岳麓区
济南	济南市
萧山	萧山区
舞钢	舞钢市
魏县	魏县
临川	临川区
四川	四川省
三水	三水区
北塘	北塘区
玉溪	玉溪市
保亭	保亭黎族苗族自治县
路桥	路桥区
玛曲	玛曲县
广南	广南县
五营	五营区
云龙	云龙区
青羊	青羊区
嘉陵	嘉陵区
郫县	郫县
赞皇	赞皇县
宽城	宽城满族自治县
邢台	邢台县
内蒙古	内蒙古自治区
磴口	磴口县
湖北	湖北省
重庆	重庆市
丰顺	丰顺县
闽清	闽清县
晋中	晋中市
临县	临县
黔西南	黔西南布依族苗族自治州
南平	南平市
荆门	荆门市
呼玛	呼玛县
固阳	固阳县
华宁	华宁县
赫山	赫山区
公主岭	公主岭市
德钦	德钦县
通海	通海县
荆州	荆州区
梁园	梁园区
雨花	雨花区
辽源	辽源市
广安	广安市
贵定	贵定县
枣庄	枣庄市
琅琊	琅琊区
乌前旗	乌拉特前旗
沽源	沽源县
葫芦岛	葫芦岛市
长春	长春市
丹东	丹东市
河池	河池市
文山	文山壮族苗族自治州
安岳	安岳县
马鞍山	马鞍山市
大邑	大邑县
辉县	辉县市
洪山	洪山区
绩溪	绩溪县
广水	广水市
奉贤	奉贤区
开平	开平市
武威	武威市
阜新	阜新市
怀柔	怀柔区
商丘	商丘市
塔城	塔城地区
思明	思明区
凤凰	凤凰县
玄武	玄武区
渝北	渝北区
碑林	碑林区
黄浦	黄浦区
莲湖	莲湖区
晋安	晋安区
浦东	浦东新区
开远	开远市
个旧	个旧市
黄石	黄石市
方正	方正县
江苏	江苏省
辽阳	辽阳县
博罗	博罗县
张家口	张家口市
中山	中山市
昌都	昌都地区
龙门	龙门县
会泽	会泽县
茂名	茂名市
盐城	盐城市
杭州	杭州市
藤县	藤县
常山	常山县
林芝	林芝地区
通州	通州区
宿迁	宿迁市
迪庆	迪庆藏族自治州
兰州	兰州市
宝鸡	宝鸡市
贵阳	贵阳市
桂林	桂林市
黄埔	黄埔区
厦门	厦门市
乌鲁木齐	乌鲁木齐市
青岛	青岛市
平昌	平昌县
丽江	丽江市
攀枝花	攀枝花市
寿阳	寿阳县
腾冲	腾冲县
红桥	红桥区
龙岩	龙岩市
衡水	衡水市
相山	相山区
从江	从江县
资阳	资阳市
三都	三都水族自治县
休宁	休宁县
六安	六安市
乐东	乐东黎族自治县
雷波	雷波县
五家渠	五家渠市
永仁	永仁县
福贡	福贡县
迁安	迁安市
广元	广元市
义县	义县
张店	张店区
关岭	关岭布依族苗族自治县
凤泉	凤泉区
梁河	梁河县
景谷	景谷县
秦淮	秦淮区
连南	连南瑶族自治县
深圳	深圳市
达拉特	达拉特旗
江门	江门市
武鸣	武鸣县
铜陵	铜陵市
扬中	扬中市
平鲁	平鲁区
庆阳	庆阳市
宾阳	宾阳县
回民	回民区
日照	日照市
娄烦	娄烦县
乐清	乐清市
西山	西山区
城区	城区
靖安	靖安县
连城	连城县
宣威	宣威市
官渡	官渡区
远安	远安县
高邮	高邮市
江油	江油市
松滋	松滋市
合阳	合阳县
图木舒克	图木舒克市
大理	大理白族自治州
乌海	乌海市
溪湖	溪湖区
蓬安	蓬安县
吉林	吉林省
垣曲	垣曲县
岳西	岳西县
调兵山	调兵山市
南充	南充市
阿克苏	阿克苏地区
广宁	广宁县
揭东	揭东县
遵义	遵义市
临夏	临夏回族自治州
大足	大足县
山东	山东省
河北	河北区
荆州	荆州市
巩留	巩留县
楚雄	楚雄市
湛江	湛江市
浑源	浑源县
牡丹	牡丹区
韶关	韶关市
邹城	邹城市
吉首	吉首市
大英	大英县
巢湖	巢湖市
仁怀	仁怀市
城关	城关区
张家界	张家界市
浦江	浦江县
鹤壁	鹤壁市
弥勒	弥勒县
三门峡	三门峡市
山西	山西省
淄博	淄博市
澄江	澄江县
思茅	思茅区
泉山	泉山区
那曲	那曲地区
大余	大余县
召陵	召陵区
蜀山	蜀山区
丽水	丽水市
丰宁	丰宁满族自治县
爱民	爱民区
淅川	淅川县
胶州	胶州市
景德镇	景德镇市
拉孜	拉孜县
城厢	城厢区
邵阳	邵阳市
任丘	任丘市
天镇	天镇县
信阳	信阳市
延平	延平区
岳阳	岳阳市
道县	道县
甘谷	甘谷县
安阳	安阳市
威宁	威宁彝族回族苗族自治县
道里	道里区
卢龙	卢龙县
古城	古城区
土右旗	土默特右旗
镇沅	镇沅县
龙陵	龙陵县
楚雄	楚雄彝族自治州
康定	康定县
昌平	昌平区
青海	青海省
崇左	崇左市
道孚	道孚县
陕西	陕西省
连平	连平县
富县	富县
奎文	奎文区
武进	武进区
社旗	社旗县
昌吉	昌吉回族自治州
若尔盖	若尔盖县
吐鲁番	吐鲁番地区
温县	温县
抚州	抚州市
通城	通城县
鄂尔多斯	鄂尔多斯市
海口	海口市
昭阳	昭阳区
郴州	郴州市
吴桥	吴桥县
新洲	新洲区
日土	日土县
龙州	龙州县
新疆	新疆维吾尔族自治区
椒江	椒江区
米林	米林县
尚义	尚义县
施甸	施甸县
富顺	富顺县
同江	同江市
广西	广西壮族自治区
江达	江达县
成都	成都市
清原	清原满族自治县
晋城	晋城市
温州	温州市
遂溪	遂溪县
江岸	江岸区
盖州	盖州市
陆河	陆河县
眉山	眉山市
兰溪	兰溪市
莒南	莒南县
金华	金华市
繁峙	繁峙县
广德	广德县
柏乡	柏乡县
祁阳	祁阳县
浮梁	浮梁县
东山	东山县
中甸	香格里拉县
大同	大同市
安丘	安丘市
武侯	武侯区
定西	定西市
鸡西	鸡西市
白城	白城市
廊坊	廊坊市
遂宁	遂宁市
东港	东港市
黄南	黄南藏族自治州
屏边	屏边县
汝城	汝城县
武陵源	武陵源区
沈阳	沈阳市
定襄	定襄县
铜山	铜山县
鄯善	鄯善县
文山	文山县
芮城	芮城县
陵水	陵水黎族自治县
西双版纳	西双版纳傣族自治州
桓仁	桓仁满族自治县
秀洲	秀洲区
贡山	贡山县
大冶	大冶市
和平	和平区
紫金	紫金县
咸阳	咸阳市
白银	白银市
双桥	双桥区
英山	英山县
巴林右	巴林右旗
彭州	彭州市
韩城	韩城市
兴山	兴山区
临沧	临沧市
文成	文成县
凤阳	凤阳县
贵港	贵港市
衡阳	衡阳市
含山	含山县
扬州	扬州市
河源	河源市
昭苏	昭苏县
黄石港	黄石港区
咸宁	咸宁市
鹤岗	鹤岗市
吕梁	吕梁市
罗平	罗平县
张掖	张掖市
湘西	湘西州
麒麟	麒麟区
哈尔滨	哈尔滨市
榆次	榆次区
禄劝	禄劝县
庐山	庐山区
天门	天门市
芷江	芷江侗族自治县
东兴	东兴区
金平苗族瑶族傣族自治县	金平县
泰安	泰安市
永胜	永胜县
尖草坪	尖草坪区
威信	威信县
汨罗	汨罗市
南海	南海区
平定	平定县
广安	广安区
师宗	师宗县
临翔	临翔区
萧县	萧县
西陵	西陵区
山南	山南地区
昌江	昌江黎族自治县
麻栗坡	麻栗坡县
东城	东城区
郑州	郑州市
桐乡	桐乡市
营山	营山县
易县	易县
仁寿	仁寿县
白沙	白沙黎族自治县
石河子	石河子市
长岛	长岛县
安顺	安顺市
香港	香港
余杭	余杭区
吉林	吉林市
象州	象州县
黔东南	黔东南苗族侗族自治州
尼勒克	尼勒克县
武定	武定县
伊通	伊通满族自治县
梅州	梅州市
广灵	广灵县
金寨	金寨县
怀仁	怀仁县
洪湖	洪湖市
汉中	汉中市
芗城	芗城区
定州	定州市
咸安	咸安区
安庆	安庆市
昌吉	昌吉市
山海关	山海关区
宝兴	宝兴县
滨州	滨州市
华龙	华龙区
琼山	琼山区
涉县	涉县
开平	开平区
洞头	洞头县
墨玉	墨玉县
福州	福州市
连云港	连云港市
志丹	志丹县
萝北	萝北县
库伦	库伦旗
和平	和平县
赤城	赤城县
西峡	西峡县
曲松	曲松县
爱辉	爱辉区
九原	九原区
元谋	元谋县
铜梁	铜梁县
石屏	石屏县
南京	南京市
吴忠	吴忠市
巴南	巴南区
蒙自	蒙自县
文昌	文昌市
南昌	南昌市
振兴	振兴区
武陵	武陵区
普兰	普兰县
江州	江州区
大连	大连市
水磨沟	水磨沟区
温岭	温岭市
凤庆	凤庆县
霍城	霍城县
禄丰	禄丰县
富宁	富宁县
息烽	息烽县
赤水	赤水市
离岛	离岛区
泸州	泸州市
义乌	义乌市
农安	农安县
衢州	衢州市
南江	南江县
城区	城区
建阳	建阳市
宝坻	宝坻区
兴化	兴化市
黎川	黎川县
马边	马边彝族自治县
镇雄	镇雄县
宜宾	宜宾县
涟水	涟水县
桃城	桃城区
青阳	青阳县
红河	红河哈尼族彝族自治州
南通	南通市
果洛	果洛藏族自治州
沧浪	沧浪区
潮州	潮州市
永新	永新县
温江	温江区
淮南	淮南市
西宁	西宁市
松原	松原市
长寿	长寿区
台江	台江县
台江	台江区
达州	达州市
南川	南川区
合肥	合肥市
慈利	慈利县
定日	定日县
本溪	本溪市
十堰	十堰市
吐鲁番	吐鲁番市
永宁	永宁县
牟定	牟定县
砚山	砚山县
新兴	新兴县
拉萨	拉萨市
泸水	泸水县
合江	合江县
源城	源城区
鞍山	鞍山市
凉山	凉山州
安达	安达市
崇川	崇川区
巴林左	巴林左旗
加格达奇	加格达奇区
中宁	中宁县
博尔塔拉	博尔塔拉蒙古自治州
顺昌	顺昌县
鹤庆	鹤庆县
冀州	冀州市
太原	太原市
吉安	吉安市
天祝	天祝藏族自治县
天津	天津市
锡盟	锡林郭勒盟
彭水	彭水苗族土家族自治县
江东	江东区
淮安	淮安市
石家庄	石家庄市
渭南	渭南市
景宁	景宁畲族自治县
阜阳	阜阳市
漳州	漳州市
润州	润州区
江汉	江汉区
兴安	兴安县
内江	内江市
绵阳	绵阳市
新邵	新邵县
鄂州	鄂州市
渝中	渝中区
黑水	黑水县
新乡	新乡市
海北	海北藏族自治州
佛坪	佛坪县
晋源	晋源区
海拉尔	海拉尔区
建水	建水县
青河	青河县
抚顺	抚顺县
南丰	南丰县
卓尼	卓尼县
富源	富源县
云南	云南省
乳源	乳源瑶族自治县
江都	江都市
河南	河南省
台州	台州市
屯昌	屯昌县
靖西	靖西县
铁东	铁东区
夏河	夏河县
武江	武江区
华县	华县
柳州	柳州市
仁和	仁和区
井陉	井陉县
武都	武都区
静安	静安区
新都	新都区
泗洪	泗洪县
青神	青神县
嘉峪关	嘉峪关市
平泉	平泉县
屏南	屏南县
川汇	川汇区
潮阳	潮阳区
兴城	兴城市
榕城	榕城区
运城	运城市
澳门	澳门特别行政区
富阳	富阳市
通辽	通辽市
河西	河西区
铜仁	铜仁地区
铜川	铜川市
济源	济源市
连云	连云区
监利	监利县
临江	临江市
保山	保山市
达县	达县
徐闻	徐闻县
龙文	龙文区
怀化	怀化市
南丹	南丹县
凌河	凌河区
铁岭	铁岭市
黔西	黔西县
红塔	红塔区
满城	满城县
株洲	株洲县
抚宁	抚宁县
乐平	乐平市
格尔木	格尔木市
桥东	桥东区
克孜勒苏柯尔克孜	克孜勒苏柯尔克孜自治州
兴县	兴县
龙南	龙南县
吉木乃	吉木乃县
新晃	新晃侗族自治县
涿鹿	涿鹿县
永春	永春县
秦都	秦都区
墨江	墨江县
洛浦	洛浦县
长治	长治市
涧西	涧西区
常熟	常熟市
南宁	南宁市
秀英	秀英区
泉州	泉州市
呼伦贝尔	呼伦贝尔市
南汇	南汇区
沙河	沙河市
红河	红河县
雁塔	雁塔区
东宝	东宝区
阿勒泰	阿勒泰地区
固原	固原市
日喀则	日喀则市
阿盟	阿拉善盟
巧家	巧家县
长沙	长沙市
瓮安	瓮安县
番禺	番禺区
平江	平江县
东丽	东丽区
科右中旗	科尔沁右翼中旗
孝感	孝感市
西藏	西藏自治区
井冈山	井冈山市
云县	云县
贺兰	贺兰县
东营	东营市
榆阳	榆阳区
大同	大同县
安化	安化县
宿松	宿松县
镇赉	镇赉县
怒江	怒江傈僳族自治州
台湾	台湾省
直布罗陀	直布罗陀
卢森堡	卢森堡
马耳他	马耳他
塞舌尔	塞舌尔
新加坡	新加坡
波多	波多
Channel_Islands	Channel_Islands
England	England
安圭拉	安圭拉
巴哈	巴哈
巴林	巴林
巴斯	巴斯
多巴哥	多巴哥
梵蒂冈	梵蒂冈
根西岛	根西岛
科威特	科威特
利兹	利兹
马尔代夫	马尔代夫
马绍尔	马绍尔
毛里求斯	毛里求斯
摩纳哥	摩纳哥
墨西哥	墨西哥
诺福克岛	诺福克岛
萨尔瓦多	萨尔瓦多
圣马力诺	圣马力诺
台北	台北市
台南	台南市
台中	台中市
突尼斯	突尼斯
瓦努阿图	瓦努阿图
维多利亚	维多利亚
文莱	文莱
新竹	新竹市
泽西	泽西
